1111111111111111111111111111111111
1P000000000000000000000000000001C1
1E00000000000000000000000000000101
1111111111111111111111111111111111
