1111111111111111111111111111111111111111111111111111111
1PCCCCCCCCCCCCCCCCCCCCCCCCCCCCCCCCCCCCCCCCCCCCCCCCCCCC1
1E000000000000000000000000000000000000000000000000000C1
1000000110000000111111110N001111111100000011111100000C1
1CC00010100000010000000100010000000100000000000100000C1
1C000100100000000000001000000000001000000000000100000C1
1C001000100000000000010000000000010000000000000100000C1
1C000000100000000001000000000001000000000001111111100C1
1C000000100000000000010000000000010000000000000100000C1
1C000000100000000000001000000000001000000000000100000C1
1C000000100000000000000100000000000100000000000100000C1
1C000000100000010000000010010000000010000000000100000C1
1C000011111000001111111100001111111100000000000100000C1
1C000000000000000000NNNN000000000000000000N0000000000C1
1CCCCCCCCCCCCCCCCCCCCCCCCCCCCCCCCCCCCCCCCCCCCCCCCCCCCC1
1111111111111111111111111111111111111111111111111111111
