111111111111111111111111111111111111111111111111111
1PCCCCCCCCCCCCCCCCCCCCCCCCCCCCCCCCCCCCCCCCCCCCCCCC1
1E00000000000000000000000000000000000000000000000C1
1000011000001111111100001111111100001111111111000C1
1CC0101000010000000100010000000100000000000001000C1
1C01001000000000001000000000001000000000000001000C1
1C10001000000000010000000000010000000000000001000C1
1C00001000000001000000000001000000000000011111111C1
1C00001000000000010000000000010000000000000001000C1
1C00001000000000001000000000001000000000000001000C1
1C00001000000000000100000000000100000000000001000C1
1C00001000010000000010010000000010000000000001000C1
1C00111110001111111100001111111100000000000001000C1
1C00000000000000000000000000000000000000000000000C1
1CCCCCCCCCCCCCCCCCCCCCCCCCCCCCCCCCCCCCCCCCCCCCCCCC1
111111111111111111111111111111111111111111111111111
