111111111111111111111111111111111111
1N00000001CCCCCCCCCCCCCCC100000000N1
1000000001C0000000000000C10000000001
1001111001C000000E000000C10011111001
1001000001C0011111111000C100000N1001
1001000001C0000000000000C10000001001
100100000000000000000000000000001001
10010000000000000N000000000000001001
100000000000000000000000000000000001
100111111001100000000011001111111001
10000000000100000C000001000000000001
1000N00000010000000000010000000N0001
100000000001C0000N0000C1000000000001
100111111001111111111111001111111001
100000000000000000000000000000000001
100000000000000000000000000000000001
10C100000000000000000000000000001C01
10C100000000000000000000000000001C01
10C1000001C0011111111000C10000001C01
10C1000001C0000000000000C10000001C01
10C1111001C0000000000000C10011111C01
10C0000001C000000N000000C100CCCCCC01
1P00000001CCCCCCCCCCCCCCC100000000N1
111111111111111111111111111111111111